#########
#S      #
# ### # #
#   # # #
### # # #
#     # #
# ##### #
#      E#
#########