5 7
#######
#I #  #
# ### #
#   #F#
#######