12 12
############
#I#      # #
# # #### # #
# # #  # # #
#   # ## # #
###   ## # #
# ###    # #
#   #####  #
# #     ####
# # #####  #
#     #   F#
############